sapiens	ADJ
inane	NOUN
mormyr	NOUN
arianus	NOUN
chrisma	NOUN
large	ADJ
regulo	VERB
byrsa	NOUN
conuictus	NOUN
tmolites	NOUN
nubigena	NOUN
syllogismus	NOUN
inuectus	NOUN
tyrrhenus	NOUN
fitilla	NOUN
nomas	NOUN
trogus	NOUN
hildipertulus	NOUN
amiprandus	NOUN
aegina	NOUN
saepes	NOUN
muscarium	NOUN
αγωνισμα	X
platanus	NOUN
staberius	NOUN
meconitis	NOUN
nerullinus	NOUN
uolturcius	NOUN
euphrates	NOUN
ualerius	NOUN
panormita	NOUN
pampinus	NOUN
inula	NOUN
pyladus	NOUN
pictones	NOUN
sutrinum	NOUN
moesi	NOUN
constratum	NOUN
επιστησατε	X
anatina	NOUN
ataprandus	NOUN
thraca	NOUN
tubus	NOUN
rem	NOUN
quieto	VERB
rudo	VERB
aliter	DET
larga	NOUN
fabrico	VERB
ampliatus	NOUN
habitualiter	ADJ
haud	PART
cicaro	NOUN
heres	NOUN
templum	NOUN
hypsipyle	NOUN
actorides	NOUN
zelotes	NOUN
nauarra	NOUN
anhelus	ADJ
zorobabel	NOUN
popanum	NOUN
eusebes	NOUN
uonones	NOUN
ue	CCONJ
coniurati	NOUN
mali	NOUN
quotlibet	DET
mamilianus	NOUN
comunis	ADJ
araldus	NOUN
magniprandus	NOUN
enuntiatum	NOUN
euclides	NOUN
extrinsece	PRON
uisibiliter	ADJ
sociatus	ADJ
thalassa	NOUN
acmon	NOUN
macro	NOUN
matrinius	NOUN
secreto	VERB
murgantini	NOUN
wilichaus	NOUN
mela	NOUN
cantium	NOUN
allus	NOUN
tuum	NOUN
phrenesis	NOUN
ampulla	NOUN
lychnus	NOUN
byzantium	NOUN
substantificus	ADJ
heredito	VERB
adhaesus	NOUN
circe	NOUN
culmen	NOUN
iuncita	NOUN
o	INTJ
casmilla	NOUN
